//Nats
O
(S O)
(S(S O))
(S(S(S O)))
(S(S(S(S O))))
(S(S(S(S(S O)))))

//ListNats
Empty
(Cons (S O) Empty) => [1]
(Cons (S(S(S O))) (Cons (S(S O)) (Cons (S(S O)) Empty))) => [3,2]
(Cons (S O) (Cons (S O) (Cons (S O) (Cons (S O) Empty)))) => [1,1,1,1]


length :: ListNat -> Nat
length Empty = O
length (Cons x xs) = S(length xs)

concat :: ListNat -> ListNat -> ListNat
concat Empty xs = xs
concat (Cons x xs) ys = Cons x (concat xs ys)

sumList :: ListNat -> Nat
sumList Empty = O
sumList (Cons x xs) = sum x (sumList xs)

productList :: ListNat -> Nat
productList Empty = (S O)
productList (Cons x xs) = mult x (productList xs)

append :: Nat -> ListNat -> ListNat
append x Empty = (Cons x Empty)
append x (Cons y ys) = Cons y (append x ys)

reverse :: ListNat -> ListNat
reverse Empty = Empty
reverse (Cons x xs) = append x (reverse xs)
